"filename", "language", "TypeScript JSX", "comment", "blank", "total"
"/Users/mphelps/climb_w_friends_v2/src/pages/homeComponents/homeObjects.tsx", "TypeScript JSX", 0, 0, 3, 3
"/Users/mphelps/climb_w_friends_v2/src/pages/mapComponents/activityFeed.tsx", "TypeScript JSX", 3, 0, 0, 3
"/Users/mphelps/climb_w_friends_v2/src/pages/mapComponents/climbModal.tsx", "TypeScript JSX", -1, 0, 0, -1
"/Users/mphelps/climb_w_friends_v2/src/pages/mapComponents/mapNavBar.tsx", "TypeScript JSX", 1, 0, 0, 1
"/Users/mphelps/climb_w_friends_v2/src/pages/mapComponents/mapObjects.tsx", "TypeScript JSX", 82, 0, -3, 79
"/Users/mphelps/climb_w_friends_v2/src/pages/mapComponents/modalComponents/filterModal.tsx", "TypeScript JSX", 68, 1, 30, 99
"/Users/mphelps/climb_w_friends_v2/src/pages/mapComponents/modalComponents/modalSearch.tsx", "TypeScript JSX", 7, -8, -2, -3
"/Users/mphelps/climb_w_friends_v2/src/reusableComponents/downDrop.tsx", "TypeScript JSX", 6, 0, -2, 4
"/Users/mphelps/climb_w_friends_v2/src/reusableComponents/dropDown.tsx", "TypeScript JSX", 12, 0, -7, 5
"/Users/mphelps/climb_w_friends_v2/src/reusableComponents/purpleButton.tsx", "TypeScript JSX", 0, 0, 1, 1
"/Users/mphelps/climb_w_friends_v2/src/reusableComponents/styles.tsx", "TypeScript JSX", 10, 0, -1, 9
"Total", "-", 188, -7, 19, 200