"filename", "language", "TypeScript JSX", "comment", "blank", "total"
"/Users/mphelps/climb_w_friends_v2/src/pages/homeComponents/maps.tsx", "TypeScript JSX", 4, 0, 0, 4
"/Users/mphelps/climb_w_friends_v2/src/pages/map.tsx", "TypeScript JSX", 3, 0, 1, 4
"/Users/mphelps/climb_w_friends_v2/src/pages/mapComponents/climbModal.tsx", "TypeScript JSX", 169, 0, 15, 184
"/Users/mphelps/climb_w_friends_v2/src/pages/mapComponents/mapObjects.tsx", "TypeScript JSX", 12, 0, 1, 13
"/Users/mphelps/climb_w_friends_v2/src/pages/mapComponents/modalComponents/chatOverlay.tsx", "TypeScript JSX", 89, 1, 9, 99
"/Users/mphelps/climb_w_friends_v2/src/pages/mapComponents/modalComponents/filterModal.tsx", "TypeScript JSX", 5, 0, -1, 4
"/Users/mphelps/climb_w_friends_v2/src/pages/mapComponents/modalComponents/filterModalComponents.tsx/GradeDropDowns.tsx", "TypeScript JSX", -1, 0, 0, -1
"/Users/mphelps/climb_w_friends_v2/src/pages/mapComponents/modalComponents/modalChat.tsx", "TypeScript JSX", -97, -1, -9, -107
"/Users/mphelps/climb_w_friends_v2/src/pages/mapComponents/modalComponents/tagOverlay.tsx", "TypeScript JSX", 16, 0, 2, 18
"Total", "-", 200, 0, 18, 218