"filename", "language", "C#", "comment", "blank", "total"
"/Users/mphelps/climb_w_friends_v2/ClimbWithFriendsAPI/ClimbWithFriendsAPI/Controllers/AttemptsController.cs", "C#", 132, 10, 41, 183
"/Users/mphelps/climb_w_friends_v2/ClimbWithFriendsAPI/ClimbWithFriendsAPI/Controllers/ClimbChatController.cs", "C#", 88, 40, 22, 150
"/Users/mphelps/climb_w_friends_v2/ClimbWithFriendsAPI/ClimbWithFriendsAPI/Controllers/ClimbsController.cs", "C#", 129, 88, 62, 279
"/Users/mphelps/climb_w_friends_v2/ClimbWithFriendsAPI/ClimbWithFriendsAPI/Controllers/FeaturesController.cs", "C#", 537, 106, 130, 773
"/Users/mphelps/climb_w_friends_v2/ClimbWithFriendsAPI/ClimbWithFriendsAPI/Controllers/FilterController.cs", "C#", 174, 33, 57, 264
"/Users/mphelps/climb_w_friends_v2/ClimbWithFriendsAPI/ClimbWithFriendsAPI/Controllers/MapsController.cs", "C#", 168, 69, 59, 296
"/Users/mphelps/climb_w_friends_v2/ClimbWithFriendsAPI/ClimbWithFriendsAPI/Controllers/TagsController.cs", "C#", 135, 5, 31, 171
"/Users/mphelps/climb_w_friends_v2/ClimbWithFriendsAPI/ClimbWithFriendsAPI/Controllers/TicksController.cs", "C#", 114, 8, 22, 144
"/Users/mphelps/climb_w_friends_v2/ClimbWithFriendsAPI/ClimbWithFriendsAPI/Controllers/UserController.cs", "C#", 96, 9, 18, 123
"Total", "-", 1573, 368, 442, 2383