"filename", "language", "C#", "TypeScript JSX", "CSS", "TypeScript", "XML", "comment", "blank", "total"
"/Users/mphelps/climb_w_friends_v2/ClimbWithFriendsAPI/ClimbWithFriendsAPI/Data/AppDbContext.cs", "C#", 51, 0, 0, 0, 0, 5, 12, 68
"/Users/mphelps/climb_w_friends_v2/ClimbWithFriendsAPI/ClimbWithFriendsAPI/Data/Attempt.cs", "C#", 22, 0, 0, 0, 0, 0, 3, 25
"/Users/mphelps/climb_w_friends_v2/ClimbWithFriendsAPI/ClimbWithFriendsAPI/Data/Climb.cs", "C#", 72, 0, 0, 0, 0, 0, 6, 78
"/Users/mphelps/climb_w_friends_v2/ClimbWithFriendsAPI/ClimbWithFriendsAPI/Data/ClimbChat.cs", "C#", 28, 0, 0, 0, 0, 0, 5, 33
"/Users/mphelps/climb_w_friends_v2/ClimbWithFriendsAPI/ClimbWithFriendsAPI/Data/ClimbToTag.cs", "C#", 12, 0, 0, 0, 0, 1, 4, 17
"/Users/mphelps/climb_w_friends_v2/ClimbWithFriendsAPI/ClimbWithFriendsAPI/Data/Configurations/AttemptConfiguration.cs", "C#", 35, 0, 0, 0, 0, 1, 7, 43
"/Users/mphelps/climb_w_friends_v2/ClimbWithFriendsAPI/ClimbWithFriendsAPI/Data/Configurations/ClimbChatConfiguration.cs", "C#", 34, 0, 0, 0, 0, 1, 9, 44
"/Users/mphelps/climb_w_friends_v2/ClimbWithFriendsAPI/ClimbWithFriendsAPI/Data/Configurations/ClimbConfiguration.cs", "C#", 61, 0, 0, 0, 0, 4, 9, 74
"/Users/mphelps/climb_w_friends_v2/ClimbWithFriendsAPI/ClimbWithFriendsAPI/Data/Configurations/ClimbToTagConfiguration.cs", "C#", 33, 0, 0, 0, 0, 6, 7, 46
"/Users/mphelps/climb_w_friends_v2/ClimbWithFriendsAPI/ClimbWithFriendsAPI/Data/Configurations/FeatureConfiguration.cs", "C#", 26, 0, 0, 0, 0, 3, 9, 38
"/Users/mphelps/climb_w_friends_v2/ClimbWithFriendsAPI/ClimbWithFriendsAPI/Data/Configurations/GradeRangeFilterConfigurations.cs", "C#", 24, 0, 0, 0, 0, 0, 12, 36
"/Users/mphelps/climb_w_friends_v2/ClimbWithFriendsAPI/ClimbWithFriendsAPI/Data/Configurations/MapConfiguration.cs", "C#", 57, 0, 0, 0, 0, 1, 7, 65
"/Users/mphelps/climb_w_friends_v2/ClimbWithFriendsAPI/ClimbWithFriendsAPI/Data/Configurations/MapToFeatureToClimbConfiguration.cs", "C#", 29, 0, 0, 0, 0, 2, 5, 36
"/Users/mphelps/climb_w_friends_v2/ClimbWithFriendsAPI/ClimbWithFriendsAPI/Data/Configurations/MapToTagConfiguration.cs", "C#", 33, 0, 0, 0, 0, 2, 7, 42
"/Users/mphelps/climb_w_friends_v2/ClimbWithFriendsAPI/ClimbWithFriendsAPI/Data/Configurations/MapToUserConfiguration.cs", "C#", 27, 0, 0, 0, 0, 16, 9, 52
"/Users/mphelps/climb_w_friends_v2/ClimbWithFriendsAPI/ClimbWithFriendsAPI/Data/Configurations/MapToUserToClimbConfiguration.cs", "C#", 28, 0, 0, 0, 0, 1, 7, 36
"/Users/mphelps/climb_w_friends_v2/ClimbWithFriendsAPI/ClimbWithFriendsAPI/Data/Configurations/TagConfiguration.cs", "C#", 57, 0, 0, 0, 0, 1, 11, 69
"/Users/mphelps/climb_w_friends_v2/ClimbWithFriendsAPI/ClimbWithFriendsAPI/Data/Configurations/TagFilterConfigurations.cs", "C#", 23, 0, 0, 0, 0, 0, 10, 33
"/Users/mphelps/climb_w_friends_v2/ClimbWithFriendsAPI/ClimbWithFriendsAPI/Data/Configurations/TickConfiguration.cs", "C#", 34, 0, 0, 0, 0, 1, 9, 44
"/Users/mphelps/climb_w_friends_v2/ClimbWithFriendsAPI/ClimbWithFriendsAPI/Data/Configurations/UserFilterConfigurations.cs", "C#", 27, 0, 0, 0, 0, 0, 10, 37
"/Users/mphelps/climb_w_friends_v2/ClimbWithFriendsAPI/ClimbWithFriendsAPI/Data/Feature.cs", "C#", 75, 0, 0, 0, 0, 1, 19, 95
"/Users/mphelps/climb_w_friends_v2/ClimbWithFriendsAPI/ClimbWithFriendsAPI/Data/GradeRangeFilter.cs", "C#", 16, 0, 0, 0, 0, 0, 4, 20
"/Users/mphelps/climb_w_friends_v2/ClimbWithFriendsAPI/ClimbWithFriendsAPI/Data/Map.cs", "C#", 16, 0, 0, 0, 0, 0, 2, 18
"/Users/mphelps/climb_w_friends_v2/ClimbWithFriendsAPI/ClimbWithFriendsAPI/Data/MapToFeatureToClimb.cs", "C#", 12, 0, 0, 0, 0, 1, 4, 17
"/Users/mphelps/climb_w_friends_v2/ClimbWithFriendsAPI/ClimbWithFriendsAPI/Data/MapToTag.cs", "C#", 12, 0, 0, 0, 0, 1, 4, 17
"/Users/mphelps/climb_w_friends_v2/ClimbWithFriendsAPI/ClimbWithFriendsAPI/Data/MapToUser.cs", "C#", 11, 0, 0, 0, 0, 1, 3, 15
"/Users/mphelps/climb_w_friends_v2/ClimbWithFriendsAPI/ClimbWithFriendsAPI/Data/MapToUserToClimb.cs", "C#", 17, 0, 0, 0, 0, 1, 6, 24
"/Users/mphelps/climb_w_friends_v2/ClimbWithFriendsAPI/ClimbWithFriendsAPI/Data/Tag.cs", "C#", 18, 0, 0, 0, 0, 1, 9, 28
"/Users/mphelps/climb_w_friends_v2/ClimbWithFriendsAPI/ClimbWithFriendsAPI/Data/TagFilter.cs", "C#", 15, 0, 0, 0, 0, 0, 4, 19
"/Users/mphelps/climb_w_friends_v2/ClimbWithFriendsAPI/ClimbWithFriendsAPI/Data/Ticks.cs", "C#", 22, 0, 0, 0, 0, 0, 4, 26
"/Users/mphelps/climb_w_friends_v2/ClimbWithFriendsAPI/ClimbWithFriendsAPI/Data/User.cs", "C#", 24, 0, 0, 0, 0, 0, 10, 34
"/Users/mphelps/climb_w_friends_v2/ClimbWithFriendsAPI/ClimbWithFriendsAPI/Data/UserFilter.cs", "C#", 17, 0, 0, 0, 0, 0, 4, 21
"/Users/mphelps/climb_w_friends_v2/src/App.tsx", "TypeScript JSX", 0, -11, 0, 0, 0, 0, -2, -13
"/Users/mphelps/climb_w_friends_v2/src/assets/react.svg", "XML", 0, 0, 0, 0, -1, 0, 0, -1
"/Users/mphelps/climb_w_friends_v2/src/index.css", "CSS", 0, 0, -34, 0, 0, -4, -5, -43
"/Users/mphelps/climb_w_friends_v2/src/main.tsx", "TypeScript JSX", 0, -29, 0, 0, 0, -2, -3, -34
"/Users/mphelps/climb_w_friends_v2/src/pages/dashboard.tsx", "TypeScript JSX", 0, -26, 0, 0, 0, 0, -4, -30
"/Users/mphelps/climb_w_friends_v2/src/pages/dashboardComponents/dashboardObjects.tsx", "TypeScript JSX", 0, -377, 0, 0, 0, 0, -2, -379
"/Users/mphelps/climb_w_friends_v2/src/pages/dashboardComponents/maps.tsx", "TypeScript JSX", 0, -253, 0, 0, 0, -9, -27, -289
"/Users/mphelps/climb_w_friends_v2/src/pages/dashboardComponents/mapsComponents/addMapModal.tsx", "TypeScript JSX", 0, -113, 0, 0, 0, -1, -10, -124
"/Users/mphelps/climb_w_friends_v2/src/pages/dashboardComponents/mapsComponents/editModal.tsx", "TypeScript JSX", 0, -307, 0, 0, 0, -2, -21, -330
"/Users/mphelps/climb_w_friends_v2/src/pages/dashboardComponents/navBar.tsx", "TypeScript JSX", 0, -87, 0, 0, 0, 0, -11, -98
"/Users/mphelps/climb_w_friends_v2/src/pages/dashboardComponents/utilityFunctions.tsx", "TypeScript JSX", 0, -199, 0, 0, 0, -16, -29, -244
"/Users/mphelps/climb_w_friends_v2/src/pages/filterProvider.tsx", "TypeScript JSX", 0, -28, 0, 0, 0, 0, -7, -35
"/Users/mphelps/climb_w_friends_v2/src/pages/homeComponents/homeNavBar.tsx", "TypeScript JSX", 0, -39, 0, 0, 0, 0, -5, -44
"/Users/mphelps/climb_w_friends_v2/src/pages/login.tsx", "TypeScript JSX", 0, -17, 0, 0, 0, -1, -7, -25
"/Users/mphelps/climb_w_friends_v2/src/pages/map.tsx", "TypeScript JSX", 0, -359, 0, 0, 0, -14, -57, -430
"/Users/mphelps/climb_w_friends_v2/src/pages/mapComponents/activityFeed.tsx", "TypeScript JSX", 0, -62, 0, 0, 0, -1, -9, -72
"/Users/mphelps/climb_w_friends_v2/src/pages/mapComponents/attemptOverlay.tsx", "TypeScript JSX", 0, -188, 0, 0, 0, -3, -16, -207
"/Users/mphelps/climb_w_friends_v2/src/pages/mapComponents/chatOverlay.tsx", "TypeScript JSX", 0, -149, 0, 0, 0, -1, -10, -160
"/Users/mphelps/climb_w_friends_v2/src/pages/mapComponents/gradeComparison.ts", "TypeScript", 0, 0, 0, -131, 0, -20, -26, -177
"/Users/mphelps/climb_w_friends_v2/src/pages/mapComponents/mapApiRequests.tsx", "TypeScript JSX", 0, -674, 0, 0, 0, -22, -78, -774
"/Users/mphelps/climb_w_friends_v2/src/pages/mapComponents/mapLayers.tsx", "TypeScript JSX", 0, -448, 0, 0, 0, -65, -46, -559
"/Users/mphelps/climb_w_friends_v2/src/pages/mapComponents/mapNavBar.tsx", "TypeScript JSX", 0, -95, 0, 0, 0, 0, -3, -98
"/Users/mphelps/climb_w_friends_v2/src/pages/mapComponents/mapObjects.tsx", "TypeScript JSX", 0, -247, 0, 0, 0, 0, -9, -256
"/Users/mphelps/climb_w_friends_v2/src/pages/mapComponents/modalComponents/addClimbModal.tsx", "TypeScript JSX", 0, -500, 0, 0, 0, -18, -59, -577
"/Users/mphelps/climb_w_friends_v2/src/pages/mapComponents/modalComponents/allClimbsModal.tsx", "TypeScript JSX", 0, -32, 0, 0, 0, 0, -3, -35
"/Users/mphelps/climb_w_friends_v2/src/pages/mapComponents/modalComponents/climbModal.tsx", "TypeScript JSX", 0, -331, 0, 0, 0, -9, -35, -375
"/Users/mphelps/climb_w_friends_v2/src/pages/mapComponents/modalComponents/filterModal.tsx", "TypeScript JSX", 0, -322, 0, 0, 0, -12, -46, -380
"/Users/mphelps/climb_w_friends_v2/src/pages/mapComponents/modalComponents/filterModalComponents.tsx/GradeDropDowns.tsx", "TypeScript JSX", 0, -140, 0, 0, 0, -2, -9, -151
"/Users/mphelps/climb_w_friends_v2/src/pages/mapComponents/modalComponents/modalSearch.tsx", "TypeScript JSX", 0, -83, 0, 0, 0, -1, -12, -96
"/Users/mphelps/climb_w_friends_v2/src/pages/mapComponents/modalComponents/modalTag.tsx", "TypeScript JSX", 0, -152, 0, 0, 0, -4, -15, -171
"/Users/mphelps/climb_w_friends_v2/src/pages/mapComponents/modalComponents/tagOverlay.tsx", "TypeScript JSX", 0, -16, 0, 0, 0, 0, -2, -18
"/Users/mphelps/climb_w_friends_v2/src/pages/mapComponents/popup.css", "CSS", 0, 0, -28, 0, 0, -3, -3, -34
"/Users/mphelps/climb_w_friends_v2/src/pages/mapComponents/search.tsx", "TypeScript JSX", 0, -171, 0, 0, 0, -5, -12, -188
"/Users/mphelps/climb_w_friends_v2/src/pages/mapComponents/tickAndAttempt.tsx", "TypeScript JSX", 0, -157, 0, 0, 0, -4, -9, -170
"/Users/mphelps/climb_w_friends_v2/src/pages/mapComponents/tickOverlay.tsx", "TypeScript JSX", 0, -186, 0, 0, 0, -2, -17, -205
"/Users/mphelps/climb_w_friends_v2/src/pages/mapbox.css", "CSS", 0, 0, -12, 0, 0, 0, -1, -13
"/Users/mphelps/climb_w_friends_v2/src/reusableComponents/chatInput.tsx", "TypeScript JSX", 0, -33, 0, 0, 0, 0, -4, -37
"/Users/mphelps/climb_w_friends_v2/src/reusableComponents/climbModalBar.tsx", "TypeScript JSX", 0, -334, 0, 0, 0, -6, -21, -361
"/Users/mphelps/climb_w_friends_v2/src/reusableComponents/downDrop.tsx", "TypeScript JSX", 0, -53, 0, 0, 0, 0, -2, -55
"/Users/mphelps/climb_w_friends_v2/src/reusableComponents/dropDown.tsx", "TypeScript JSX", 0, -93, 0, 0, 0, 0, -9, -102
"/Users/mphelps/climb_w_friends_v2/src/reusableComponents/genericButton.tsx", "TypeScript JSX", 0, -30, 0, 0, 0, 0, -1, -31
"/Users/mphelps/climb_w_friends_v2/src/reusableComponents/genericModal.tsx", "TypeScript JSX", 0, -48, 0, 0, 0, -2, -5, -55
"/Users/mphelps/climb_w_friends_v2/src/reusableComponents/input.tsx", "TypeScript JSX", 0, -47, 0, 0, 0, 0, -8, -55
"/Users/mphelps/climb_w_friends_v2/src/reusableComponents/loginButton.tsx", "TypeScript JSX", 0, -20, 0, 0, 0, 0, -4, -24
"/Users/mphelps/climb_w_friends_v2/src/reusableComponents/logoutButton.tsx", "TypeScript JSX", 0, -22, 0, 0, 0, 0, -4, -26
"/Users/mphelps/climb_w_friends_v2/src/reusableComponents/searchDropDown.tsx", "TypeScript JSX", 0, -50, 0, 0, 0, 0, -6, -56
"/Users/mphelps/climb_w_friends_v2/src/reusableComponents/styles.tsx", "TypeScript JSX", 0, -386, 0, 0, 0, 0, -26, -412
"/Users/mphelps/climb_w_friends_v2/src/reusableComponents/toastContainer.tsx", "TypeScript JSX", 0, -53, 0, 0, 0, 0, -8, -61
"/Users/mphelps/climb_w_friends_v2/src/reusableComponents/toastNotification.tsx", "TypeScript JSX", 0, -98, 0, 0, 0, -3, -9, -110
"/Users/mphelps/climb_w_friends_v2/src/reusableComponents/toolTip.tsx", "TypeScript JSX", 0, -65, 0, 0, 0, -2, -6, -73
"/Users/mphelps/climb_w_friends_v2/src/supaBaseClient.tsx", "TypeScript JSX", 0, -45, 0, 0, 0, -1, -12, -58
"/Users/mphelps/climb_w_friends_v2/src/types/Posts.ts", "TypeScript", 0, 0, 0, -5, 0, 0, -1, -6
"/Users/mphelps/climb_w_friends_v2/src/types/interfaces.tsx", "TypeScript JSX", 0, -138, 0, 0, 0, 0, -22, -160
"Total", "-", 968, -7313, -74, -136, -1, -184, -527, -7267