"filename", "language", "TypeScript JSX", "CSS", "TypeScript", "XML", "comment", "blank", "total"
"/Users/mphelps/climb_w_friends_v2/src/App.css", "CSS", 0, 37, 0, 0, 0, 6, 43
"/Users/mphelps/climb_w_friends_v2/src/App.tsx", "TypeScript JSX", 11, 0, 0, 0, 32, 3, 46
"/Users/mphelps/climb_w_friends_v2/src/assets/react.svg", "XML", 0, 0, 0, 1, 0, 0, 1
"/Users/mphelps/climb_w_friends_v2/src/index.css", "CSS", 0, 64, 0, 0, 0, 9, 73
"/Users/mphelps/climb_w_friends_v2/src/main.tsx", "TypeScript JSX", 21, 0, 0, 0, 1, 3, 25
"/Users/mphelps/climb_w_friends_v2/src/pages/filterProvider.tsx", "TypeScript JSX", 28, 0, 0, 0, 0, 7, 35
"/Users/mphelps/climb_w_friends_v2/src/pages/home.tsx", "TypeScript JSX", 11, 0, 0, 0, 0, 1, 12
"/Users/mphelps/climb_w_friends_v2/src/pages/homeComponents/homeObjects.tsx", "TypeScript JSX", 377, 0, 0, 0, 0, 2, 379
"/Users/mphelps/climb_w_friends_v2/src/pages/homeComponents/maps.tsx", "TypeScript JSX", 113, 0, 0, 0, 0, 10, 123
"/Users/mphelps/climb_w_friends_v2/src/pages/homeComponents/mapsComponents/addMapModal.tsx", "TypeScript JSX", 76, 0, 0, 0, 1, 5, 82
"/Users/mphelps/climb_w_friends_v2/src/pages/homeComponents/mapsComponents/editModal.tsx", "TypeScript JSX", 222, 0, 0, 0, 0, 15, 237
"/Users/mphelps/climb_w_friends_v2/src/pages/homeComponents/navBar.tsx", "TypeScript JSX", 30, 0, 0, 0, 0, 4, 34
"/Users/mphelps/climb_w_friends_v2/src/pages/login.tsx", "TypeScript JSX", 81, 0, 0, 0, 10, 13, 104
"/Users/mphelps/climb_w_friends_v2/src/pages/map.tsx", "TypeScript JSX", 208, 0, 0, 0, 6, 39, 253
"/Users/mphelps/climb_w_friends_v2/src/pages/mapComponents/activityFeed.tsx", "TypeScript JSX", 62, 0, 0, 0, 1, 9, 72
"/Users/mphelps/climb_w_friends_v2/src/pages/mapComponents/allClimbsModal.tsx", "TypeScript JSX", 26, 0, 0, 0, 0, 4, 30
"/Users/mphelps/climb_w_friends_v2/src/pages/mapComponents/climbModal.tsx", "TypeScript JSX", 316, 0, 0, 0, 1, 26, 343
"/Users/mphelps/climb_w_friends_v2/src/pages/mapComponents/mapLayers.tsx", "TypeScript JSX", 297, 0, 0, 0, 45, 28, 370
"/Users/mphelps/climb_w_friends_v2/src/pages/mapComponents/mapNavBar.tsx", "TypeScript JSX", 95, 0, 0, 0, 0, 3, 98
"/Users/mphelps/climb_w_friends_v2/src/pages/mapComponents/mapObjects.tsx", "TypeScript JSX", 456, 0, 0, 0, 0, 12, 468
"/Users/mphelps/climb_w_friends_v2/src/pages/mapComponents/modalComponents/chatOverlay.tsx", "TypeScript JSX", 89, 0, 0, 0, 1, 9, 99
"/Users/mphelps/climb_w_friends_v2/src/pages/mapComponents/modalComponents/filterModal.tsx", "TypeScript JSX", 252, 0, 0, 0, 3, 24, 279
"/Users/mphelps/climb_w_friends_v2/src/pages/mapComponents/modalComponents/filterModalComponents.tsx/GradeDropDowns.tsx", "TypeScript JSX", 67, 0, 0, 0, 0, 6, 73
"/Users/mphelps/climb_w_friends_v2/src/pages/mapComponents/modalComponents/modalSearch.tsx", "TypeScript JSX", 82, 0, 0, 0, 1, 12, 95
"/Users/mphelps/climb_w_friends_v2/src/pages/mapComponents/modalComponents/modalTag.tsx", "TypeScript JSX", 79, 0, 0, 0, 2, 10, 91
"/Users/mphelps/climb_w_friends_v2/src/pages/mapComponents/modalComponents/tagOverlay.tsx", "TypeScript JSX", 16, 0, 0, 0, 0, 2, 18
"/Users/mphelps/climb_w_friends_v2/src/pages/mapComponents/search.tsx", "TypeScript JSX", 138, 0, 0, 0, 0, 15, 153
"/Users/mphelps/climb_w_friends_v2/src/reusableComponents/chatInput.tsx", "TypeScript JSX", 34, 0, 0, 0, 0, 4, 38
"/Users/mphelps/climb_w_friends_v2/src/reusableComponents/downDrop.tsx", "TypeScript JSX", 51, 0, 0, 0, 0, 2, 53
"/Users/mphelps/climb_w_friends_v2/src/reusableComponents/dropDown.tsx", "TypeScript JSX", 89, 0, 0, 0, 0, 9, 98
"/Users/mphelps/climb_w_friends_v2/src/reusableComponents/input.tsx", "TypeScript JSX", 38, 0, 0, 0, 0, 8, 46
"/Users/mphelps/climb_w_friends_v2/src/reusableComponents/purpleButton.tsx", "TypeScript JSX", 18, 0, 0, 0, 0, 1, 19
"/Users/mphelps/climb_w_friends_v2/src/reusableComponents/searchDropDown.tsx", "TypeScript JSX", 44, 0, 0, 0, 0, 6, 50
"/Users/mphelps/climb_w_friends_v2/src/reusableComponents/styles.tsx", "TypeScript JSX", 332, 0, 0, 0, 0, 22, 354
"/Users/mphelps/climb_w_friends_v2/src/reusableComponents/toolTip.tsx", "TypeScript JSX", 65, 0, 0, 0, 2, 6, 73
"/Users/mphelps/climb_w_friends_v2/src/reusableComponents/zincModal.tsx", "TypeScript JSX", 42, 0, 0, 0, 2, 5, 49
"/Users/mphelps/climb_w_friends_v2/src/supaBaseClient.tsx", "TypeScript JSX", 45, 0, 0, 0, 1, 12, 58
"/Users/mphelps/climb_w_friends_v2/src/types/Posts.ts", "TypeScript", 0, 0, 5, 0, 0, 1, 6
"/Users/mphelps/climb_w_friends_v2/src/types/interfaces.tsx", "TypeScript JSX", 51, 0, 0, 0, 0, 6, 57
"Total", "-", 3962, 101, 5, 1, 109, 359, 4537